%%%%%%%%%%%%%%%%%%%%%%%%%%%
% ......    ....  ......  %
%o.   ...  ..... ...  ... %
%     ... .. ... ...  o.. %
%  ......    ... ...  ... %
%  ......  P ... ...  ... %
%     ...    ... ...  ... %
%..   ...    ... ...  ... %
% ......    .... P......  %
%%%%%%%%%%%%%%%%%%%%%%%%%%%