%%%%%
%...%
%.P.%
%.o.%
%...%
%...%
%...%
%...%
%P..%
%%%%%
